%%%%%%%%%%%%%%%%%%%%
% P           %    %
% %% %% %% %% %% % %
%                % %
%%%%%%%%%%%%%%%%%% %
%                  %
%%%%%%%%%%%%%%%%%%%%
